"filename", "language", "TypeScript JSX", "comment", "blank", "total"
"/home/pranshubarar/Project Integration files /CueCollab Files/CueCollabProject/CueCollab/CueCollab-Frontend/contexts/AllInsideRoomContexts/ChatsContext.tsx", "TypeScript JSX", 0, 0, 1, 1
"/home/pranshubarar/Project Integration files /CueCollab Files/CueCollabProject/CueCollab/CueCollab-Frontend/contexts/AllInsideRoomContexts/CurrentRoomIdContext.tsx", "TypeScript JSX", 22, 0, 6, 28
"/home/pranshubarar/Project Integration files /CueCollab Files/CueCollabProject/CueCollab/CueCollab-Frontend/contexts/AllInsideRoomContexts/ParticipantsContext.tsx", "TypeScript JSX", 53, 0, 19, 72
"/home/pranshubarar/Project Integration files /CueCollab Files/CueCollabProject/CueCollab/CueCollab-Frontend/contexts/AllInsideRoomContexts/VideosContext.tsx", "TypeScript JSX", 107, 73, 67, 247
"/home/pranshubarar/Project Integration files /CueCollab Files/CueCollabProject/CueCollab/CueCollab-Frontend/contexts/AuthContext.tsx", "TypeScript JSX", 25, 0, 5, 30
"/home/pranshubarar/Project Integration files /CueCollab Files/CueCollabProject/CueCollab/CueCollab-Frontend/contexts/DestinationContext.tsx", "TypeScript JSX", 46, 0, 10, 56
"/home/pranshubarar/Project Integration files /CueCollab Files/CueCollabProject/CueCollab/CueCollab-Frontend/contexts/EmailContext.tsx", "TypeScript JSX", 21, 13, 5, 39
"/home/pranshubarar/Project Integration files /CueCollab Files/CueCollabProject/CueCollab/CueCollab-Frontend/contexts/RoomInvitesContext.tsx", "TypeScript JSX", 52, 0, 21, 73
"/home/pranshubarar/Project Integration files /CueCollab Files/CueCollabProject/CueCollab/CueCollab-Frontend/contexts/RoomSummaryContext.tsx", "TypeScript JSX", 47, 87, 38, 172
"/home/pranshubarar/Project Integration files /CueCollab Files/CueCollabProject/CueCollab/CueCollab-Frontend/contexts/UserAccountDetailsContext.tsx", "TypeScript JSX", 68, 256, 108, 432
"Total", "-", 441, 429, 280, 1150